basioccipital_proc_ant	neurocranium
basisphenoid_ant	neurocranium
basisphenoid_post	neurocranium
cranium_sagittal	neurocranium
cranium_occipital	neurocranium
foramen_magnum_sup	neurocranium
jugal_upperbeak_R	upperbeak
jugal_upperbeak_L	upperbeak
mand_condyle_quadrate_lat_R	quadrate_R
mand_condyle_quadrate_lat_L	quadrate_L
mand_condyle_quadrate_med_R	quadrate_R
mand_condyle_quadrate_med_L	quadrate_L
nasalfrontalhinge_cranium_R	upperbeak
nasalfrontalhinge_cranium_L	upperbeak
occipital_condyle	neurocranium
opisthotic_process_R	neurocranium
opisthotic_process_L	neurocranium
orbital_proc_quadrate_distal_R	quadrate_R
orbital_proc_quadrate_distal_L	quadrate_L
orbital_proc_quadrate_sup_base_R	quadrate_R
orbital_proc_quadrate_sup_base_L	quadrate_L
orbital_proc_quadrate_inf_base_R	quadrate_R
orbital_proc_quadrate_inf_base_L	quadrate_L
palatine_med_crest_R	palatine_R
palatine_lat_crest_R	palatine_R
palatine_med_crest_L	palatine_L
palatine_lat_crest_L	palatine_L
postorbital_process_distal_sup_R	neurocranium
postorbital_process_distal_sup_L	neurocranium
preorbital_process_distal_R	neurocranium
preorbital_process_distal_L	neurocranium
pslider_palatine_R	palatine_R
pslider_palatine_L	palatine_L
pslider_pterygoid_R	pterygoid_R
pslider_pterygoid_L	pterygoid_L
pterygoid_palatine_R	pterygoid_R
pterygoid_palatine_L	pterygoid_L
quadrate_cranium_lc_R	neurocranium
quadrate_cranium_lc_L	neurocranium
quadrate_cranium_mc_R	neurocranium
quadrate_cranium_mc_L	neurocranium
quadrate_jugal_R	quadrate_R
quadrate_jugal_L	quadrate_L
quadrate_pterygoid_R	quadrate_R
quadrate_pterygoid_L	quadrate_L
palatine_lat_crest_ant_R	upperbeak
palatine_lat_crest_ant_L	upperbeak
palatine_med_crest_ant_R	upperbeak
palatine_med_crest_ant_L	upperbeak
upperbeak_palatine_R	upperbeak
upperbeak_palatine_L	upperbeak
upperbeak_tomium_prox_R	upperbeak
upperbeak_tomium_prox_L	upperbeak
upperbill_cranium	neurocranium
upper_bill_culmen	upperbeak
upper_bill_tomium_R	upperbeak
upper_bill_tomium_L	upperbeak
upperbeak_tip	upperbeak
